┏┓┏┓┏┓┏┓┏┓┏┓┏┳┓
┃┃┃┃┃┃┃┃┃┃┃┃┃┃┃
┃┃┃┃┃┃┃┃┃┃┣╋╋╋┫
┣╋╋╋┫┃┃┃┃┃┃┃┃┃┃
┃┃┃┃┃┃┃┃┣╋╋╋┫┃┃
┃┃┃┃┃┃┃┃┃┃┃┃┃┃┃
┣╋╋╋╋╋╋╋╋╋╋╋╋╋┫
┃┃┃┃┃┃┃┃┃┃┃┃┃┃┃
┃┃┃┃┃┃┣┻┫┃┃┃┃┃┃
┃┃┃┃┃┃┃□┃┃┃┃┃┃┃
┃┃┃┃┃┃┣┳┫┃┃┃┃┃┃
┃┃┃┃┃┃┃┃┃┃┃┃┃┃┃
┣┫┃┃┃┣╋╋╋┫┃┃┃┣┫
↑┃┃┃┃┃┃┃┃┃┃┃┃┃↑
→┻┛┗┛┗┛┗┛┗┛┗┻┻←